####################################
#****####****##***********###******#
#****####****##***#***###*****####*#
#*##***+**##****##***##****##***+**#
#*#######*##*##*##******##*##*######
#*##*********##*##***##*##*********#
#****####*##***************##*####*#
#*##**#****##**************##******#
#*###*#**##*##*### ###*##*##*#######
#*###*#*****##*#     #*##**********#
 ***#*#*****##*#     #*##****##****
 *******#*#*##*#     #*##*######***
#*#####*#*#*##*#     #*##*##*******#
#*#*###*#*#*##*### ###*##******#*#*#
#*#*****#*#******* *******##*###*#*#
#*#*###*#*#*##*#######*##*##*#***#*#
#***#***#*#*##*#######*##*##*#*#*#*#
#*###*#*#*#*##*********##*##*#*#*#*#
#*****+*****##*###*###*##*#********#
#*#########*##*###*###*##*####***+*#
#**********************************#
####################################