####################################
#****####****##***********###******#
#****####****##***#***###*****####*#
#*##******##****##***##****##******#
#*#######*##*##*##******##*##+######
#*##+********##*##***##*##*********#
#****####*##***************##*####*#
#*##**#****##**************##******#
#*###*#**##*##*### ###*##*##****####
#*##**#*****##*#     #*##**###*****#
#*#***#*****##*#     #*##**********#
#*#*****#*#*##*#     #*##*######***#
#*##*##*#*#*##*#     #*##*##*******#
#*#**##*#*#*##*### ###*##******#*#*#
#*******#*#******* *******##*###*#*#
#*#*###*#*#*##*###*###*##*##*#***#*#
#***#***#*#*##*###*###*##*##*#*#*#*#
#*###*#*#*#*##*********##*##*#*#*#*#
#*****+*****##*#**#**#*##*#+*******#
 *#########*##*#**#**#*##*####*****
 *****************#****************
####################################