##################  ################
#*******#****##***********###******#
#**###*##****##***#***###**##*####*#
#*###**+**##****##***##****##***+**#
#*#######*##*##*##******##****##*###
#*##*********##*##***##*##*********#
#****####*##****#**********#**#****#
#*##**#****##**************#**#****#
#*###*#**##*##*### ###*##*##**######
#*###*#*****##*#     #*##**********#
#***#*#*****##*#     #*##****##****#
#*******#*#*##*#     #*##*######***#
#*#####*#*#*##*#     #*##*##*******#
#*#*###*#*#*##*### ###*##******#*#*#
#*#*****#*#*****## *******##*###*#*#
#*#*###*#*#*##***#*###*##*##*#***#*#
#***#***#*#*##***#*###*##*##*#*#*#*#
#*###*#*#*#*##*********##*##*#*#*#*#
#*****+*****##*###*###*##*#********#
#*####*####*##*###*###*#######*****#
#**********************#######+****#
##################  ################