####################################
 **######****##***#***###*###******
 ****####****##***#***###*****##***
#*##***+**##****##***##****##***+**#
#*#######*##*##*#*******##*##*######
#*##*********##*#****##*##*****##**#
#****####*##****#**********##***#**#
#*##**#****##**##***##*****##***#**#
#*###*#**##*##*### ###*##**######**#
#*###*#*****##*#     #*##**********#
#***#*#*****##*#     #*##****##****#
#*******#*#*##*#     #*##*######***#
#*#####*#*#*##*#     #*##*##*******#
#*#*###*#*#*##*### ###*##******#*#*#
#*#*****#*#******* *******##*###*#*#
#*#*###*#*#*##*********##*##*#***#*#
#***#***#*#*##*#*#*#*#*##*##*#*#*#*#
#*###*#*#*#*##*#*#*#*#*##*##*#*#*#*#
#***********##*#*#*#*#*##*#********#
#*#########*##*#*#*#*#*##*####***+*#
#*****+*****##*********##**********#
####################################