####################################
#**######****##***#***###*###******#
#****####****##***#***###*****##***#
#*##******##****##***##*+**##******#
#*#######*##*##*#*******##*##*######
#*##*********##*#****##*##*****##**#
#**+*####*##****#**********##***#**#
#*##**#****##**##***##*****##***#**#
#*###*#**##*##*### ###*##**######**#
#*###*#*****##*#     #*##**********#
#***#*#*****##*#     #*##****##****#
#*******#*#*##*#     #*##*######***#
#*#####*#*#*##*#     #*##*##*******#
#*#*###*#*#*##*### ###*##******#*#*#
#*#*****#*#******* *******##########
#*#*###*#*#*##*********##*#****#*#*#
#***#***#*#*##*#*#*#*#*##*#*#**#*#*#
#*###*#*#*#*##*#*#*#*#*##*#*#**#*#*#
#***********##*#*#*#*#*##*#*#******#
 *#########*##*#*#*#*#*##*#*#****+*
 *****+*****##*********##***#******
####################################