####################################
 ***#*#*#*#*#*#*#*#*#*#*#*#*#*#*#**
 **********************************
#*#*###+#*#*#*###*#*#*#*#*###*#*+#*#
#*****#*****#*****#*****#*****#****#
#*#*#*#*#*#*#######*#*#*#######*#*##
#**********************************#
#*#*#*#*#*#*#**#*#*#*#*#*#*#*#*#*#*#
#*###*#**##*##*### ###*##**######**#
#*###*#*****##*#     #*##**********#
#***#*#*****##*#     #*##****##****#
#*******#*#*##*#     #*##*######***#
#*#####*#*#*##*#     #*##*##*******#
#*#*###*#*#*##*### ###*##******#*#*#
#*#*****#*#******* *******##*###*#*#
#*#*###*#*#*##*********##*##*#***#*#
#***#***#*#*##*#*#*#*#*##*##*#*#*#*#
#*###*#*#*#*##*#*#*#*#*##*##*#*#*#*#
#***********##*#*#*#*#*##*#********#
#*#########*##*#*#*#*#*##*####***+*#
#*****+*****##*********##**********#
####################################