####################################
 *****#******##***#*******#####****
 ****##******##***#*##**##*****##**
#***#+#******##*#***##*##********#*#
#*****#******##*#*#*##*#**********##
#*****#******##*#*#*##******+******#
#*****#*********#*#*##************##
#**#######*****##***##***********###
#*###*#**##*##*### ###**********##*#
#*###*#*****##*#     #********##***#
#***#*#*****##*#     #******##*****#
#*******#*#*##*#     #****##*******#
#*#####*#*#*##*#     #**##*********#
#*#*###*#*#*##*### #####***********#
#*#*****#*#******* **#############*#
#*#*###*#*#*##*********************#
#***#***#*#*##*#*#*#***************#
#*###*#*#*#*##*#*#*#******##*#*#*#*#
#***********##*#*#*#*#*##*#********#
#*#########*##*#*#*#*#*##*####***+*#
#*****+*****##*********************#
####################################