####################################
 ********#*********###########*****
 *******#***#***#***#**#*******#*#*
#******#+*****#***#*********####+#*#
#*****#*****#***#***#*#*#******#*#*#
#****####*****#***#**#***#*###*#*#*#
#**##****##*****#***#**********#*#*#
#**#*******#**#****#########*#*****#
#**********#***### ###*##**#*####**#
#**##*****#*##*#     #*##**********#
#****####***##*#     #*##****##**#*#
#*******#*#*##*#     #*##*######***#
#*#####*#*#*##*#     #*##*##*******#
#*#*###*#*#*##*### ###*##******#*#*#
#*#*****#*#******* *******##*###*#*#
#*#*###*#*#*##*********##*##*#***#*#
#***#***#*#*##*#*#*#*#*##*##*#*#*#*#
#*###*#*#*#*##*#*#*#*#*##*##*#*#*#*#
#***********##*#*#*#*#*##*#********#
#*#########*##*#*#*#*#*##*####***+*#
#*****+*****##*********##**********#
####################################