####################################
#  #           *                   #
#        ####       #              #
#                   #              #
#                           *      #
#   *      #                       #
#          #                       #
#          ##             *        #
#                #          #      #
#   *                       #      #
#                           #      #
#     *               *     #      #
#             *      #      #      #
#                    #      #   *  #
#             ########      #      #
#    *              #       #      #
#             #   *   #     #  *   #
#         ####                     #
#                                  #
#                          *       #
#             *                    #
#                                  #
####################################