####################################
#  #           *                   #
#        ####       #              #
#    *              #              #
#                           *      #
#          #                       #
#          #                       #
#      ######             * ##     #
#                #          #   *  #
#             *             ##     #
#          #            #######   ##
#     *    #       *               #
#          #                       #
#          #                       #
#        ######     #              #
#    *              #              #
#                   #              #
#         ##      ###  *           #
#                   #              #
#                          *       #
#   *         *                    #
#                                  #
####################################