####################################
#  #           *                   #
#        ####       #####          #
#       *                          #
#                           *      #
#          #                       #
#   *      #                       #
#          ##             *        #
#                ##                #
#                                  #
#               *            *     #
#     *  ###################       #
#                       *          #
#                                  #
#             ########             #
#    *                   *         #
#                    *             #
#         #######                  #
#                                  #
#    *                     *       #
#             *      *             #
#                  ###             #
####################################