####################################
#  #           *                   #
#        ####       #              #
#         #         #              #
#         #                 *      #
#         #                        #
#         #     *                  #
#     #   #               *        #
#     #  *#   #########   ##       #
#     #  *#        *               #
#     #  *#                        #
#     #  *#                        #
#     #######         *            #
#                                  #
#                                  #
#    *        #                    #
#             #         ############
#######                 #      *   #
#      *                #          #
#                       #  *       #
#             *                    #
#                                  #
####################################