####################################
#           #   *                  #
#           #                      #
#           #                      #
#        *  #               *      #
#      ######                      #
#           #   *                  #
#           #             *        #
#  ########                        #
#       #*         *               #
#    #   *                         #
#     #  *           ##########    #
#                    #*            #
# ##########         #             #
# #        #         #             #
# #  * #   #                       #
# #    ##  #         #             #
# #   *#   #         #         *   #
# #   ##   #         ############# #
# #  ####  #               *       #
#   ###### #  *                    #
#                                  #
####################################