####################################
#              *                   #
#                                  #
#                                  #
#                 #         *      #
#                # #               #
#               #   #              #
#              #     #    *        #
#        *    #       #            #
#        *   #   * *   #           #
#        *                         #
#        * #             #         #
#            ###########*          #
#        # #             # #       #
#       #   #           #   #      #
#    * #     #         #     #     #
#     #       #       #       #    #
#                              #*  #
#   #  *        #   #           #  #
#  ############### ###############*#
#             *                    #
#                                  #
####################################