####################################
#  #           *                   #
#          ##     #                #
#        #        #  ########  ### #
#       ### #        #        *  # #
#       ###  #    #  #     #     # #
#       ###   #   #* #     #     # #
#     # ###   #   #  #    *#     # #
#     # ### * #      #     #     # #
#     # ### * #   #  #*    #     # #
#     # ###  *          #######  # #
#     # ### * #   #  #     #     # #
#       ###       # *#     #     # #
#       ###                #     # #
#       ###       #  #     #     # #
#    *  ###   #   #   #    #    #  #
#       ###  #    #    #   #   #   #
#  ############         #     #*   #
#      * #        #          #     #
#        #        #       #*#      #
#        #     *                   #
#       ###       #                #
####################################